###############################
# . . . . . . . . . . . . . . #
# ##############.##############
#. . . . . . . . . . . . . . .#
#. . ####.##############. . . #
#. . . .# # . . . . . . . . . #
#. . . .#.##################. #
#. . . . . . . . . . . . . . .#
###############################